********XXX
*XX*XXXXXXX
*****XXX0XX
*XX***XXXXX
****X*XX**X
*XXXXX***XX
*XX****XX0X
****XX**XXX
*0*****XXXX
***********