*****XXXXX
*XXX****XX
*****XX*X*
X**XX*X*X*
XXXXX0X*XX
XX******X*
XXXXXXXXXX